7-+@
---------+
----+---++
----------
+-------+-
----------
------+---
+------+--
